111111111
100000C01
100000001
1E0000001
1P000E001
100000001
111111111
