111111111
100000001
1E0000001
1000000H1
100000001
1000C0001
111111111
