111111111111111111111111111111111111111
100000C0000000000001C000001000001C00001
100000000000000000011111101011101010101
1E00000000000000000001C0100000100010101
10000000000000000000010C101010111110101
1000000000000000000000000010000C00001P1
111111111111111111111111111111111111101
100000000000000000000000000000000000001
100000000000000000000000000000000000001
100000000000000000000000000000000000001
100000000000000000000000000000000000001
100000000000000000000000000000000000001
100000000000000000000000000000000000001
111111111111111111111111111111111111111
